AIKeywords	CorrectedAIKeywords
"\5.4\"" HAND GUN"""	\5.4\ HAND GUN
"2 ,4-DINITROTOLUENE"	"2,4 DINITROTOLUENE"
"2,4-DINITROTOLUENE"	"2,4 DINITROTOLUENE"
"SPECTROSCOPY, ABSORPTION"	ABSORPTION SPECTROSCOPY
"MICROSCOPY, ACOUSTIC"	ACOUSTIC MICROSCOPY
ADHESIVE LIFTS	ADHESIVE LIFTER
AEROSOLS	AEROSOL
AIRBAGS	AIRBAG
AIRBORNE PARTICLES	AIRBORNE PARTICLE
ALGORITHMS	ALGORITHM
ALIZARIN RED S	ALIZARIN RED S (ARS)
ALKALOIDS	ALKALOID
ALLOYS	ALLOY
ALUMINUM	ALUMINIUM (AL)
AMMUNITIONS	AMMUNITION
ANIMALS	ANIMAL
ANIONS	ANION
ANTIMONY	ANTIMONY (SB)
ANTIMONY 121	ANTIMONY (SB)
ARTIFACTS	ARTIFACT
AAS	ATOMIC ABSORPTION SPECTROSCOPY (AAS)
ATOM-ABSORPTIONS-SPEKTROPHOTOMETRIE	ATOMIC ABSORPTION SPECTROSCOPY (AAS)
ATOMIC ABSORPTION SPECTROMETRY	ATOMIC ABSORPTION SPECTROSCOPY (AAS)
ATOMIC ABSORPTION SPECTROMETRY (AAS)	ATOMIC ABSORPTION SPECTROSCOPY (AAS)
ATOMIC ABSORPTION SPECTROPHOTOMETRY	ATOMIC ABSORPTION SPECTROSCOPY (AAS)
ATOMIC ABSORPTION SPECTROSCOPY	ATOMIC ABSORPTION SPECTROSCOPY (AAS)
ATOMIC EMISSION SPECTROMETRY	ATOMIC ABSORPTION SPECTROSCOPY (AAS)
ATOMIC EMISSION SPECTROSCOPY	ATOMIC ABSORPTION SPECTROSCOPY (AAS)
"SPECTROPHOTOMETRY, ATOMIC"	ATOMIC ABSORPTION SPECTROSCOPY (AAS)
"SPECTROPHOTOMETRY, ATOMIC ABSORPTION"	ATOMIC ABSORPTION SPECTROSCOPY (AAS)
BACK-SCATTERED	BACKSCATTER
BACK SPATTER	BACKSCATTER
BACKSPATTER	BACKSCATTER
BACK SCATTERED ELECTRON (BSE) SIGNAL	BACKSCATTERED ELECTRON DETECTOR
BACKSCATTER ELECTRON DETECTOR SYSTEM	BACKSCATTERED ELECTRON DETECTOR
BALLISTICS	BALLISTIC
BARIUM	BARIUM (BA)
BARIUM 137	BARIUM (BA)
BAYES' THEOREM	BAYES THEOREM
BIRDS	BIRD
BISMUTH	BISMUTH (BI)
BODY FLUIDS	BODY FLUID
BRAKE PADS	BRAKE PAD
BULLET HOLE	BULLET HOLES
BURNS	BURN
CAMERAS	CAMERA
"ELECTROPHORESIS, CAPILLARY"	CAPILLARY ELECTROPHORESIS
CAPILLARY MICROEXTRACTION OF VOLATILE	CAPILLARY MICROEXTRACTION OF VOLATILES (CMV)
CAPILLARY MICROEXTRACTION OF VOLATILES	CAPILLARY MICROEXTRACTION OF VOLATILES (CMV)
CARBANILIDES	CARBANILIDE
CARTRIDGE CASING	CARTRIDGE CASE
CARTRIDGE DISCHARGE RESIDUE	CARTRIDGE DISCHARGE RESIDUES (CDR)
CHEMICAL COMPOSITIONS	CHEMICAL COMPOSITION
CHEMICAL COMPOUNDS	CHEMICAL COMPOUND
CHEMICAL IMAGES	CHEMICAL IMAGE
CHEMICAL WARFARE AGENT	CHEMICAL WARFARE AGENTS (CWAS)
CHEMICAL WARFARE AGENTS	CHEMICAL WARFARE AGENTS (CWAS)
CHEMOMETRIC	CHEMOMETRICS
CHEMOMETRY	CHEMOMETRICS
CONCENTRATION (PARAMETERS)	CONCENTRATION (PARAMETER)
"MICROSCOPY, CONFOCAL"	CONFOCAL MICROSCOPY
COORDINATION COMPOUNDS	COORDINATION COMPOUND
COPPER	COPPER (CU)
CRIME SCENE INVESTIGATIONS	CRIME SCENE INVESTIGATION
CYANOACRYLATES	CYANOACRYLATE
CYCLIC VOLTAMMETRIC	CYCLIC VOLTAMMETRY
CYCLIC VOLTAMMOGRAMS	CYCLIC VOLTAMMETRY
DATA SETS	DATA SET
DATA BASE	DATABASE
"DATABASES, FACTUAL"	DATABASE
DESI-MSMS	DESORPTION ELECTROSPRAY IONISATION-MASS SPECTROMETRY (DESI-MS)
DESORPTION ELECTROSPRAY IONISATION MASS SPECTROMETRY	DESORPTION ELECTROSPRAY IONISATION-MASS SPECTROMETRY (DESI-MS)
DESORPTION ELECTROSPRAY IONISATION MASS SPECTROMETRY (DESI-MS)	DESORPTION ELECTROSPRAY IONISATION-MASS SPECTROMETRY (DESI-MS)
DESORPTION ELECTROSPRAY IONIZATION MASS SPECTROMETRY	DESORPTION ELECTROSPRAY IONISATION-MASS SPECTROMETRY (DESI-MS)
DESI MASS SPECTROMETRY	DESORPTION ELECTROSPRAY IONISATION-MASS SPECTROMETRY-MASS SPECTROMETRY (DESI-MSMS)
DEVICES	DEVICE
DICARBOXYLIC ACIDS	DICARBOXYLIC ACID
DIPHENYLAMINE	DIPHENLYAMINE (DPA)
DIP PEN LITHOGRAPHY	DIP-PEN LITHOGRAPHY
DISTANCE ESTIMATION	DISTANCE DETERMINATION
DISTANCE-BASED ??PAD	DISTANCE-BASED PAD
DRUGS	DRUG
DYES	DYE
EAGLES	EAGLE
EGGS	EGG
ELECTRODES	ELECTRODE
ELECTRON MICROSCOPE	ELECTRON MICROSCOPY
ELECTRON MICROSCOPES	ELECTRON MICROSCOPY
"MICROSCOPES, ELECTRON"	ELECTRON MICROSCOPY
"MICROSCOPY, ELECTRON"	ELECTRON MICROSCOPY
ELECTRONIC TONGUES	ELECTRONIC TONGUE
ELEMENTAL COMPOSITIONS	ELEMENTAL COMPOSITION
EMISSION SPECTROMETRY	EMISSION SPECTROSCOPY
EDX	ENERGY DISPERSIVE SPECTROSCOPY (EDS)
ELECTRON DISPERSIVE SPECTROMETRY	ENERGY DISPERSIVE SPECTROSCOPY (EDS)
ENERGY-DISPERSIVE X-RAY ANALYSIS	ENERGY DISPERSIVE SPECTROSCOPY (EDS)
ENERGY DISPERSIVE ANALYSIS	ENERGY DISPERSIVE SPECTROSCOPY (EDS)
ENERGY DISPERSIVE SPECTROMETRY	ENERGY DISPERSIVE SPECTROSCOPY (EDS)
ENERGY DISPERSIVE SPECTROSCOPY	ENERGY DISPERSIVE SPECTROSCOPY (EDS)
ENERGY DISPERSIVE X- RAY ANALYSIS (EDX)	ENERGY DISPERSIVE SPECTROSCOPY (EDS)
ENERGY DISPERSIVE X-RAY	ENERGY DISPERSIVE SPECTROSCOPY (EDS)
ENERGY DISPERSIVE X-RAY ANALYSIS	ENERGY DISPERSIVE SPECTROSCOPY (EDS)
ENERGY DISPERSIVE X-RAY ANALYSIS (EDX)	ENERGY DISPERSIVE SPECTROSCOPY (EDS)
ENERGY DISPERSIVE X-RAY SPECTROMETER (EDS)	ENERGY DISPERSIVE SPECTROSCOPY (EDS)
ENERGY DISPERSIVE X-RAY SPECTROMETRY	ENERGY DISPERSIVE SPECTROSCOPY (EDS)
ENERGY DISPERSIVE X-RAY SPECTROSCOPY	ENERGY DISPERSIVE SPECTROSCOPY (EDS)
ENERGY DISPERSIVE X-RAY SPECTROSCOPY (EDS)	ENERGY DISPERSIVE SPECTROSCOPY (EDS)
ENERGY DISPERSIVE X RAY ANALYSIS	ENERGY DISPERSIVE SPECTROSCOPY (EDS)
ENERGY DISPERSIVE X RAY SPECTROMETER	ENERGY DISPERSIVE SPECTROSCOPY (EDS)
ENERGY DISPERSIVE X RAY SPECTROMETERY	ENERGY DISPERSIVE SPECTROSCOPY (EDS)
ENERGY DISPERSIVE X RAY SPECTROMETRY	ENERGY DISPERSIVE SPECTROSCOPY (EDS)
ENERGY DISPERSIVE X RAY SPECTROSCOPY	ENERGY DISPERSIVE SPECTROSCOPY (EDS)
X-RAY ENERGY DISPERSIVE SPECTROSCOPY	ENERGY DISPERSIVE SPECTROSCOPY (EDS)
X RAY ENERGY DISPERSIVE SPECTROMETRY	ENERGY DISPERSIVE SPECTROSCOPY (EDS)
ELECTRON DISPERSIVE X-RAY MICROANALYSIS	ENERGY DISPERSIVE X-RAY MICROANALYSIS
ENERGY DISPERSIVE X RAY MICROANALYSIS	ENERGY DISPERSIVE X-RAY MICROANALYSIS
ETHYL CENTRALITE	ETHYL CENTRALITE (EC)
ETHYLCENTRALITE	ETHYL CENTRALITE (EC)
ENFSI	EUROPEAN NETWORK OF FORENSIC SCIENCE INSTITUTES
EUROPEAN NETWORK OF FORENSIC SCIENCE INSTITUTE	EUROPEAN NETWORK OF FORENSIC SCIENCE INSTITUTES
EXIT WOUNDS	EXIT WOUND
FIBERS	FIBER
FIELD TESTS	FIELD TEST
FINGERS	FINGER
FINGERMARK	FINGERPRINT
FINGERMARKS	FINGERPRINT
FINGERPRINTS	FINGERPRINT
FIREARMS	FIREARM
GUN	FIREARM
GUNS	FIREARM
FDR	FIREARM DISCHARGE RESIDUE (FDR)
FIREARM DISCHARGE RESIDUE	FIREARM DISCHARGE RESIDUE (FDR)
FIREARM DISCHARGE RESIDUES	FIREARM DISCHARGE RESIDUE (FDR)
FIREARMS DISCHARGE RESIDUE (FDR)	FIREARM DISCHARGE RESIDUE (FDR)
FLUORENES	FLUORENE
"MICROSCOPY, FLUORESCENCE"	FLUORESCENCE MICROSCOPY
"SPECTROMETRY, FLUORESCENCE"	FLUORESCENCE SPECTROSCOPY
FORENSICS	FORENSICS
FORENSIC SAMPLES	FORENSIC SAMPLE
FORENSIC SCIENCES	FORENSIC SCIENCE
FORENSIC SCIENTISTS	FORENSIC SCIENTIST
FOURIER TRANSFORM INFRA RED (FTIR) SPECTROSCOPY	FOURIER TRANSFORM INFRA RED SPECTROSCOPY (FTIR)
FT-IR	FOURIER TRANSFORM INFRA RED SPECTROSCOPY (FTIR)
FTIR	FOURIER TRANSFORM INFRA RED SPECTROSCOPY (FTIR)
"SPECTROSCOPY, FOURIER TRANSFORM INFRARED"	FOURIER TRANSFORM INFRARED SPECTROSCOPY (FTIR)
GAS CHROMATOGRAPHY	GAS CHROMATOGRAPHY (GC)
GC	GAS CHROMATOGRAPHY (GC)
GAS CHROMATOGRAPHY-MASS SPECTROMETRY	GAS CHROMATOGRAPHY-MASS SPECTROMETRY (GC-MS)
GAS CHROMATOGRAPHY/MASS SPECTROMETRY	GAS CHROMATOGRAPHY-MASS SPECTROMETRY (GC-MS)
GAS CHROMATOGRAPHY?«ÙMASS SPECTROMETRY (GC?«ÙMS)	GAS CHROMATOGRAPHY-MASS SPECTROMETRY (GC-MS)
GC-MS	GAS CHROMATOGRAPHY-MASS SPECTROMETRY (GC-MS)
GC/MS	GAS CHROMATOGRAPHY-MASS SPECTROMETRY (GC-MS)
GAS CHROMATOGRAPHY-THERMAL ENERGY ANALYZER	GAS CHROMATOGRAPHY-THERMAL ENERGY ANALYZER (GC-TEA)
GC-TEA	GAS CHROMATOGRAPHY-THERMAL ENERGY ANALYZER (GC-TEA)
GC/TEA	GAS CHROMATOGRAPHY-THERMAL ENERGY ANALYZER (GC-TEA)
GOATS	GOAT
GUNPOWDER RESIDUES	GUNPOWDER RESIDUE
GSR	GUNSHOT RESIDUE (GSR)
GSR (GUNSHOT RESIDUE)	GUNSHOT RESIDUE (GSR)
GSR PARTICLES	GUNSHOT RESIDUE (GSR)
GUN SHOT RESIDUE	GUNSHOT RESIDUE (GSR)
GUN SHOT RESIDUES	GUNSHOT RESIDUE (GSR)
GUNSHOT RESIDUE	GUNSHOT RESIDUE (GSR)
GUNSHOT RESIDUE(GSR)	GUNSHOT RESIDUE (GSR)
GUNSHOT RESIDUES	GUNSHOT RESIDUE (GSR)
GUNSHOT RESIDUES (GSR)	GUNSHOT RESIDUE (GSR)
GUNSHOT RESIDUES (GSRS)	GUNSHOT RESIDUE (GSR)
GUNSHOT RESIDUES(GSRS)	GUNSHOT RESIDUE (GSR)
GSR ANALYSIS	GUNSHOT RESIDUE ANALYSIS
GUNSHOT RESIDUE (GSR) ANALYSIS	GUNSHOT RESIDUE ANALYSIS
GSR CONTAMINATION	GUNSHOT RESIDUE CONTAMINATION
GUNSHOT RESIDUE PARTICLES	GUNSHOT RESIDUE PARTICLE
GSR PATTERN	GUNSHOT RESIDUE PATTERN
GUNSHOT RESIDUE PATTERNS	GUNSHOT RESIDUE PATTERN
GUN-SHOT WOUND	GUNSHOT WOUND
GUNSHOT WOUNDS	GUNSHOT WOUND
"WOUNDS, GUNSHOT"	GUNSHOT WOUND
HAIRS	HAIR
HAND-GUN	HANDGUN
HANDGUNS	HANDGUN
HEAVY METALS	HEAVY METAL
"METALS, HEAVY"	HEAVY METALS
"CHROMATOGRAPHY, HIGH PRESSURE LIQUID"	HIGH PRESSURE LIQUID CHROMATOGRAPHY (HPLC)
HIGH-PERFORMANCE LIQUID CHROMATOGRAPHY	HIGH PRESSURE LIQUID CHROMATOGRAPHY (HPLC)
HORSES	HORSE
HUMANS	HUMAN
IMAGES	IMAGE
ICP OES	INDUCTIVELY COUPLE PLASMA/OPTICAL EMISSION SPECTROMETRY (ICP/OES)
ICP/OES	INDUCTIVELY COUPLE PLASMA/OPTICAL EMISSION SPECTROMETRY (ICP/OES)
INDUCTIVELY COUPLED PLASMA OPTICAL EMISSION SPECTROMETRY	INDUCTIVELY COUPLE PLASMA/OPTICAL EMISSION SPECTROMETRY (ICP/OES)
INDUCTIVE COUPLED PLASMA	INDUCTIVELY COUPLED PLASMA (ICP)
INDUCTIVELY COUPLED PLASMA	INDUCTIVELY COUPLED PLASMA (ICP)
ICP-AES	INDUCTIVELY COUPLED PLASMA ATOMIC EMISSION SPECTROMETRY (ICP-AES)
INDUCTIVELY COUPLED PLASMA ATOMIC EMISSION SPECTROMETER ANALYSIS	INDUCTIVELY COUPLED PLASMA ATOMIC EMISSION SPECTROMETRY (ICP-AES)
ICP-MS	(ICP-MS)
INDUCTIVELY COUPLED PLASMA-MASS SPECTROMETRY	(ICP-MS)
INDUCTIVELY COUPLED PLASMA MASS SPECTROMETRY	(ICP-MS)
INFRARED	INFRARED (IR)
INFRA-RED SPECTROSCOPY (IR)	INFRARED SPECTROSCOPY (IR)
INFRARED SPECTRAL	INFRARED SPECTROSCOPY (IR)
INFRARED SPECTROMETRY	INFRARED SPECTROSCOPY (IR)
INFRARED SPECTROSCOPY	INFRARED SPECTROSCOPY (IR)
INJURIES	INJURY
INKS	INK
IGSR	INORGANIC GUNSHOT RESIDUE (IGSR)
INORGANIC GSR	INORGANIC GUNSHOT RESIDUE (IGSR)
INORGANIC GSR (IGSR)	INORGANIC GUNSHOT RESIDUE (IGSR)
INORGANIC GUNSHOT RESIDUE	INORGANIC GUNSHOT RESIDUE (IGSR)
ION BEAM ANALYSIS	ION BEAM ANALYSIS (IBA)
"CHROMATOGRAPHY, ION EXCHANGE"	ION EXCHANGE CHROMATOGRAPHY
IMS	ION MOBILITY SPECTROMETRY (IMS)
ION MOBILITY SPECTROMETERS	ION MOBILITY SPECTROMETRY (IMS)
ION MOBILITY SPECTROMETRY	ION MOBILITY SPECTROMETRY (IMS)
IONIZATION SOURCES	IONIZATION SOURCE
ISOTOPES	ISOTOPE
?‰-KENDALL RANK CORRELATION COEFFICIENTS	KENDALL RANK CORRELATION COEFFICIENTS
LABORATORIES	LABORATORY
LANTHANIDES	LANTHANIDE
LASER ABLATION INDUCTIVELY-COUPLED PLASMA MASS SPECTROMETRIES	LASER ABLATION INDUCTIVELY COUPLED PLASMA MASS SPECTROMETRY
LASER-INDUCED BREAKDOWN SPECTROSCOPY	LASER-INDUCED BREAKDOWN SPECTROSCOPY (LIBS)
LASER INDUCED BREAKDOWN SPECTROMETERS	LASER-INDUCED BREAKDOWN SPECTROSCOPY (LIBS)
LASER INDUCED BREAKDOWN SPECTROSCOPY	LASER-INDUCED BREAKDOWN SPECTROSCOPY (LIBS)
LASERINDUCED BREAKDOWN SPECTROSCOPY (LIBS)	LASER-INDUCED BREAKDOWN SPECTROSCOPY (LIBS)
LIBS	LASER-INDUCED BREAKDOWN SPECTROSCOPY (LIBS)
LATENT FINGERPRINTS	LATENT FINGERPRINT
LEAD	LEAD (PB)
LEAD ISOTOPES	LEAD ISOTOPE
LEAD-FREE	LEAD-FREE AMMUNITION
LEAD-FREE CARTRIDGES	LEAD-FREE AMMUNITION
LEAD-FREE PRIMER RESIDUE	LEAD-FREE AMMUNITION
LEAD-FREE PRIMERS	LEAD-FREE AMMUNITION
LEADFREE AMMUNITION	LEAD-FREE AMMUNITION
LEADLESS	LEAD-FREE AMMUNITION
LEADLESS PRIMERS	LEAD-FREE AMMUNITION
LIKELIHOOD RATIOS	LIKELIHOOD RATIO
"CHROMATOGRAPHY, LIQUID"	LIQUID CHROMATOGRAPHY (LC)
LIQUID CHROMATOGRAPHY	LIQUID CHROMATOGRAPHY (LC)
LC-MS	LIQUID CHROMATOGRAPHY-MASS SPECTROSCOPY (LC-MS)
LC-MS/MS	LIQUID CHROMATOGRAPHY-MASS SPECTROSCOPY-MASS SPECTROSCOPY (LC-MS/MS)
LC?«ÙMS	LIQUID CHROMATOGRAPHY-MASS SPECTROSCOPY-MASS SPECTROSCOPY (LC-MS/MS)
LUMINESCENT MARKERS	LUMINESCENT MARKER
MASS SPECTROMETER	MASS SPECTROMETRY (MS)
MASS SPECTROMETER (MS)	MASS SPECTROMETRY (MS)
MASS SPECTROMETERS	MASS SPECTROMETRY (MS)
MASS SPECTROMETRY	MASS SPECTROMETRY (MS)
MASS-SPECTROMETRY IMAGING	MASS SPECTROMETRY IMAGING (MSI)
MEATS	MEAT
MERCURY (ELEMENT)	MERCURY
METALS	METAL
METAL-ORGANIC FRAMEWORK	METAL ORGANIC FRAMEWORK (MOF)
METAL-ORGANIC FRAMEWORKS	METAL ORGANIC FRAMEWORK (MOF)
METAL ORGANIC FRAMEWORK	METAL ORGANIC FRAMEWORK (MOF)
METALORGANIC FRAMEWORKS (MOFS)	METAL ORGANIC FRAMEWORK (MOF)
MOFS	METAL ORGANIC FRAMEWORK (MOF)
METHYL CENTRALITE	METHYL CENTRALITE (MC)
METHYLCENTRALITE	METHYL CENTRALITE (MC)
"CHROMATOGRAPHY, MICELLAR ELECTROKINETIC CAPILLARY"	MICELLAR ELECTROKINETIC CAPILLARY CHROMATOGRAPHY
MICELLAR ELECTRO-KINETIC CHROMATOGRAPHY	MICELLAR ELECTROKINETIC CHROMATOGRAPHY
MICELLE	MICELLES
MICROCT	MICRO-CT
MICROELECTRODES	MICROELECTRODE
MIDDLE AGED	MIDDLE AGE
MULTIVARIATE STATISTICAL METHODS	MULTIVARIATE STATISTICAL ANALYSIS
"N,N?«? -DIPHENYL-N,N?«? -DIETHYLUREA (ETHYL CENTRALITE)"	"N,N'-DIPHENYL-N,N'- DIETHYLUREA (ETHYL CENTRALITE)"
	NA
NAPHTHALENES	NAPHTHALENE
NAA	NEUTRON ACTIVATION ANALYSIS (NAA)
NEUTRON ACTIVATION ANALYSIS	NEUTRON ACTIVATION ANALYSIS (NAA)
NOSE HAIRS	NOSE HAIR
NUCLEAR MAGNETIC RESONANCE	NUCLEAR MAGNETIC RESONANCE (NMR)
NUCLEIC ACIDS	NUCLEIC ACID
OCCUPATIONS	OCCUPATION
OGSR	ORGANIC GUNSHOT RESIDUE (OGSR)
ORGANIC GUN SHOT RESIDUE (OGSR)	ORGANIC GUNSHOT RESIDUE (OGSR)
ORGANIC GUNSHOT RESIDUE	ORGANIC GUNSHOT RESIDUE (OGSR)
ORGANIC GUNSHOT RESIDUES	ORGANIC GUNSHOT RESIDUE (OGSR)
OXIDES	OXIDE
??PAD	PAD
PARTICLE INDUCED X-RAY EMISSION	PARTICLE INDUCED X-RAY EMISSION (PIXE)
PARTICLE INDUCED X RAY EMISSION	PARTICLE INDUCED X-RAY EMISSION (PIXE)
PIXE	PARTICLE INDUCED X-RAY EMISSION (PIXE)
PIXE MEASUREMENTS	PARTICLE INDUCED X-RAY EMISSION (PIXE)
PATTERNS	PATTERN
PHOSPHATES	PHOSPHATE
POST MORTEM INTERVALS	POST MORTEM INTERVAL (PMI)
POSTMORTEM CHANGE	POSTMORTEM CHANGES
POWDERS	POWDER
POWDER PATTERNS	POWDER PATTERN
POWDER TATTOOING	POWDER TATTOO
PRIMERS	PRIMER
PRINCIPAL COMPONENT ANALYSIS	PRINCIPAL COMPONENT ANALYSIS (PCA)
PROCEDURE	PROCEDURES
PROPELLANTS	PROPELLANT
PYROTECHNIC REACTION RESIDUES	PYROTECHNIC REACTION RESIDUE
QUESTIONNAIRE	QUESTIONNAIRES
CONFOCAL RAMAN MICROSPECTROSCOPY	RAMAN
MICRO RAMAN SPECTROSCOPY	RAMAN
RAMAN IMAGING	RAMAN
RAMAN MICROSCOPY	RAMAN
RAMAN MICROSPECTROSCOPY	RAMAN
RAMAN SCATTERING	RAMAN
RAMAN SPECTRAL IMAGING	RAMAN
RAMAN SPECTROMETRY	RAMAN
RAMAN SPECTROSCOPY	RAMAN
RAMAN TECHNIQUES	RAMAN
"SPECTRUM ANALYSIS, RAMAN"	RAMAN
SURFACE-ENHANCED RAMAN SPECTROSCOPY	RAMAN
SURFACE ENHANCED RAMAN SPECTROSCOPY	RAMAN
RANK CORRELATION COEFFICIENTS: R-SPEARMAN AND ?‰-KENDALL	RANK CORRELATION COEFFICIENTS: R-SPEARMAN AND ??-KENDALL
RATS	RAT
REACTION BAND-LENGTH ??PAD	REACTION BAND-LENGTH PAD
REVIEW [PUBLICATION TYPE]	REVIEW
REVOLVERS	REVOLVER
RIB	RIBS
SCANNING ACOUSTIC MICROSCOPY	SCANNING ACOUSTIC MICROSCOPY (SAM)
"MICROSCOPY, ELECTRON, SCANNING"	SCANNING ELECTRON MICROSCOPY (SEM)
SCANNING ELECTRON MICROSCOPE	SCANNING ELECTRON MICROSCOPY (SEM)
SCANNING ELECTRON MICROSCOPES	SCANNING ELECTRON MICROSCOPY (SEM)
SCANNING ELECTRON MICROSCOPY	SCANNING ELECTRON MICROSCOPY (SEM)
SEM	SCANNING ELECTRON MICROSCOPY (SEM)
SCANNING ELECTRON MICROSCOPE (SEM)	SCANNING ELECTRON MICROSCOPY (SEM)
SCANNING ELECTRO MICROSCOPY-ENERGY DISPERSIVE X-RAY ANALYSIS	(SEM-EDS)
SCANNING ELECTROMICROSCOPY ENERGY DISPERSIVE X-RAY ANALYSIS	(SEM-EDS)
SCANNING ELECTRON MICROSCOPE-ENERGY DISPERSIVE X-RAY SPECTROMETER	(SEM-EDS)
SCANNING ELECTRON MICROSCOPE/ENERGY DISPERSIVE X-RAY ANALYSIS	(SEM-EDS)
SCANNING ELECTRON MICROSCOPY-ENERGY-DISPERSIVE X-RAY DETECTOR (SEM-EDX)	(SEM-EDS)
SCANNING ELECTRON MICROSCOPY-ENERGY DISPERSIVE X-RAY ANALYSIS	(SEM-EDS)
SCANNING ELECTRON MICROSCOPY AND ENERGY-DISPERSIVE X-RAY ANALYSIS (SEM-EDX)	(SEM-EDS)
SCANNING ELECTRON MICROSCOPY AND ENERGY DISPERSIVE X-RAY SPECTROMETRY	(SEM-EDS)
SCANNING ELECTRON MICROSCOPY ENERGY DISPERSIVE X-RAY SPECTROSCOPY	(SEM-EDS)
SCANNING ELECTRON MICROSCOPY/ENERGY-DISPERSIVE SPECTROMETRY	(SEM-EDS)
SCANNING ELECTRON MICROSCOPY/ENERGY-DISPERSIVE SPECTROMETRY (SEM/EDS)	(SEM-EDS)
SCANNING ELECTRON MICROSCOPY/ENERGY-DISPERSIVE SPECTROSCOPY	(SEM-EDS)
SCANNING ELECTRON MICROSCOPY/ENERGY DISPERSIVE SPECTROSCOPY	(SEM-EDS)
SCANNING ELECTRON MICROSCOPY/ENERGY DISPERSIVE X-RAY ANALYSIS	(SEM-EDS)
SCANNING ELECTRON MICROSCOPY/ENERGY DISPERSIVE X-RAY SPECTROMETRY	(SEM-EDS)
SCANNING ELECTRON MICROSCOPY/ENERGY DISPERSIVE X-RAY SPECTROSCOPY (SEM/EDX)	(SEM-EDS)
SEM-EDS	(SEM-EDS)
SEM-EDS EXAMINATION	(SEM-EDS)
SEM-EDX	(SEM-EDS)
SEM-EDX ANALYSIS	(SEM-EDS)
SEM-EDXA	(SEM-EDS)
SEM + EDS	(SEM-EDS)
SEM/EDS	(SEM-EDS)
SEM/EDS ANALYSIS	(SEM-EDS)
SEM/EDX	(SEM-EDS)
SEM/EDX ANALYSIS	(SEM-EDS)
SEM?«ÙEDX	(SEM-EDS)
SCIENTISTS	SCIENTIST
SECONDARY ION MASS SPECTROMETRY	SECONDARY ION MASS SPECTROMETRY (SIMS)
SIMS	SECONDARY ION MASS SPECTROMETRY (SIMS)
"SPECTROMETRY, MASS, SECONDARY ION"	SECONDARY ION MASS SPECTROMETRY (SIMS)
SELENIUM OXIDES	SELENIUM OXIDE
SENSITIVITY ANALYSES	SENSITIVITY ANALYSIS
SCHU?É	SHOOTING
FIRING DISTANCE	SHOOTING DISTANCE DETERMINATION
FIRING RANGE	SHOOTING DISTANCE DETERMINATION
FIRING RANGE DETERMINATION	SHOOTING DISTANCE DETERMINATION
FIRING RANGES	SHOOTING DISTANCE DETERMINATION
"SCHU?ÉENTFERNUNG, TEXTILVER?ÒNDERUNGEN"	SHOOTING DISTANCE DETERMINATION
SCHU?ÉENTFERNUNGSBESTIMMUNG	SHOOTING DISTANCE DETERMINATION
SHOOTING-DISTANCE DETERMINATION	SHOOTING DISTANCE DETERMINATION
SHOOTING DISTANCE	SHOOTING DISTANCE DETERMINATION
SHOOTING DISTANCE ESTIMATION	SHOOTING DISTANCE DETERMINATION
SILICONES	SILICONE
SODIUM RHODIZONATE	SODIUM RHODIZONATE TEST (SRT)
SODIUM RHODIZONATE TEST	SODIUM RHODIZONATE TEST (SRT)
SOLID PHASE EXTRACTION	SOLID PHASE EXTRACTION (SPE)
SOLID-PHASE MICROEXTRACTION	SOLID PHASE MICRO-EXTRACTION (SPME)
SOLID PHASE MICROEXTRACTION	SOLID PHASE MICRO-EXTRACTION (SPME)
SPME	SOLID PHASE MICRO-EXTRACTION (SPME)
SPECTROMETER	SPECTROMETRY
SPECTROMETERS	SPECTROMETRY
SPENT CARTRIDGES	SPENT CARTRIDGE
SPORTS	SPORT
"WOUNDS, STAB"	STAB WOUND
STARTER?«÷S PISTOL	STARTER PISTOL
STEREOMICROSCOPY	STEREO MICROSCOPE
STUBS	STUB
SUB MICRON	SUB-MICRON
SUICIDES	SUICIDE
SUPPORT VECTOR MACHINES	SUPPORT VECTOR MACHINE
SURFACE PROPERTIES	SURFACE PROPERTY
SWABS	SWAB
SWEAT GLANDS	SWEAT GLAND
SYNCHROTRONS	SYNCHROTRON
TAPE-LIFT	TAPE LIFT
TAPE LIFT KIT	TAPE LIFT
TATTOO	TATTOOING
TEXTILES	TEXTILE
"TEXTILVER?ÒNDERUNGEN, PULVERGASE"	"TEXTILVER NDERUNGEN, PULVERGASE"
THIN FILMS	THIN FILM
"CHROMATOGRAPHY, THIN LAYER"	THIN LAYER CHROMATOGRAPHY (TLC)
THIN LAYER CHROMATOGRAPHY	THIN LAYER CHROMATOGRAPHY (TLC)
TIME FACTOR	TIME FACTORS
TIME OF FLIGHT	TIME OF FLIGHT (TOF)
TIME-OF-FLIGHT SECONDARY ION MASS SPECTROMETRY	TIME-OF-FLIGHT SECONDARY ION MASS SPECTROMETRY (TOF-SIMS)
TIME OF FLIGHT MASS SPECTROMETRY	TIME-OF-FLIGHT SECONDARY ION MASS SPECTROMETRY (TOF-SIMS)
TIME OF FLIGHT SECONDARY ION MASS SPECTROMETRY	TIME-OF-FLIGHT SECONDARY ION MASS SPECTROMETRY (TOF-SIMS)
TOF-SIMS	TIME-OF-FLIGHT SECONDARY ION MASS SPECTROMETRY (TOF-SIMS)
TOF SIMS	TIME-OF-FLIGHT SECONDARY ION MASS SPECTROMETRY (TOF-SIMS)
TISSUES	TISSUE
TOOTH FRACTURES	TOOTH FRACTURE
TRACE ELEMENT	TRACE EVIDENCE
TRACE ELEMENTS	TRACE EVIDENCE
TRACE EVIDENCE ANALYSIS	TRACE EVIDENCE
TRACE EVIDENCES	TRACE EVIDENCE
TRANSITION-EDGE SENSORS	TRANSITION-EDGE SENSOR
TRICARBOXYLIC ACIDS	TRICARBOXYLIC ACID
TRIPHENYLMETHANES	TRIPHENYLMETHANE
ULTRA-HIGH PERFORMANCE LIQUID CHROMATOGRAPHIES	ULTRA-HIGH PERFORMANCE LIQUID CHROMATOGRAPHY (UHPLC)
"SPECTROPHOTOMETRY, ULTRAVIOLET"	ULTRAVIOLET SPECTROPHOTOMETRY
ULTRAVIOLET SPECTROPHOTOMETRY	ULTRAVIOLET SPECTROSCOPY
UPLC?«ÙMS/MS	UPLC-MS/MS
VOLATILE ORGANIC COMPOUNDS	VOLATILE ORGANIC COMPOUND
WOUNDS	WOUND
X- RAY	X-RAY
X RAY	X-RAY
X RAYS	X-RAY
X RAY ABSORPTION	X-RAY ABSORPTION
X RAY ANALYSIS	X-RAY ANALYSIS
X RAY BEAM	X-RAY BEAM
X RAY DIFFRACTION	X-RAY DIFFRACTION
X RAY DOSE DISTRIBUTION	X-RAY DOSE DISTRIBUTION
"SPECTROMETRY, X-RAY EMISSION"	X-RAY EMISSION SPECTROMETRY
X-RAY EMISSION SPECTROMETRY	X-RAY EMISSION SPECTROMETRY (XES)
ENERGY DISPERSIVE X-RAY FLUORESCENCE	X-RAY ENERGY DISPERSIVE FLUORESCENCE
ENERGY DISPERSIVE X-RAY FLUORESCENCE SPECTROMETRY	X-RAY ENERGY DISPERSIVEFLUORESCENCE SPECTROMETRY
X RAY FLUORESCENCE	X-RAY FLUORESCENCE
X-RAY FLUORESCENCE	X-RAY FLUORESCENCE ANALYSIS (XRF)
X-RAY FLUORESCENCE (XRF)	X-RAY FLUORESCENCE ANALYSIS (XRF)
X-RAY FLUORESCENCE ANALYSIS	X-RAY FLUORESCENCE ANALYSIS (XRF)
X RAY FLUORESCENCE ANALYSIS	X-RAY FLUORESCENCE ANALYSIS (XRF)
X RAY FLUORESCENCE SPECTROMETRY	X-RAY FLUORESCENCE ANALYSIS (XRF)
XRAY FLUORESCENCE ANALYSIS	X-RAY FLUORESCENCE ANALYSIS (XRF)
XRF	X-RAY FLUORESCENCE ANALYSIS (XRF)
X-RAY GENERATORS	X-RAY GENERATOR
X RAY MICROANALYSIS	X-RAY MICROANALYSIS
X RAY MICRODIFFRACTION	X-RAY MICRODIFFRACTION
X-RAY MICROFLUORESCENCE	X-RAY MICROFLUORESCENCE SPECTROMETRY (MICRO-XRF)
X RAY PHOTOELECTRON SPECTROSCOPY	X-RAY PHOTOELECTRON SPECTROSCOPY (XPS)
XPS	X-RAY PHOTOELECTRON SPECTROSCOPY (XPS)
X RAY SPECTROMETRY	X-RAY SPECTROMETRY
"SPECTROSCOPY, X-RAY"	X-RAY SPECTROSCOPY
X RAY SPECTROSCOPY	X-RAY SPECTROSCOPY
ZINC	ZINC (ZN)
Z SCORES	Z-SCORES
